Hua Hin
10 kelab pantai terbaik di Hua Hin: foto, alamat, harga
Tempat untuk mencuba makanan laut yang lazat di Hua Hin: petua, harga dan alamat
Restoran Thai Terbaik di Hua Hin
Kad SIM untuk Internet mudah alih di Hua Hin
Cenderahati terbaik yang boleh anda beli di Hua Hin
Hua Hin dalam 1 hari: apa yang boleh dilihat dan ke mana hendak pergi (laluan)
Teksi di Hua Hin: cara memesan teksi dan harga
Hua Hin untuk golongan muda: perkara untuk dilakukan dan tempat untuk dilawati
Perjalanan ke Hua Hin: cara berpakaian
Pengangkutan di Hua Hin: tuk-tuk, bas dan sewaan skuter
Cara terbaik untuk ke Hua Hin: bas, kereta api, kereta
Kewangan di Hua Hin: mata wang dan pertukaran wang
Meneroka Hua Hin: Tempat Menarik, Fakta dan Pameran
10 tempat teratas untuk urutan di Hua Hin: kelonggaran dan pemulihan
Hotel Hua Hin: pilihan mewah dan bajet, harga dan ulasan
Menyewa skuter di Hua Hin: kebebasan bergerak di sekitar bandar
Sewa kereta di Hua Hin: kemudahan dan kebebasan di jalan raya
Salun kecantikan di Hua Hin: penjagaan kulit, penjagaan rambut dan kelonggaran
Salun rambut di Hua Hin: gaya rambut bergaya dan penjagaan rambut
Manikur dan pedikur di Hua Hin: penjagaan kuku yang sempurna
Kecergasan di Hua Hin: kesihatan dan gaya hidup aktif di bandar besar
Insurans perubatan di Hua Hin: bagaimana untuk memastikan keselamatan anda
Hospital dan klinik perubatan di Hua Hin: penjagaan perubatan berkualiti tinggi
Penjagaan perubatan kecemasan di Hua Hin: apa yang perlu dilakukan sekiranya berlaku kecemasan
Urutan Thai di Hua Hin: seni relaksasi dan penyembuhan purba
Urutan aroma di Hua Hin: memulihkan badan dan jiwa dengan aromaterapi
Spa Terbaik di Hua Hin: Nikmati Urutan Thai dan Aromaterapi
Pakar terapi urut profesional di Hua Hin: pengalaman dan kelayakan
Chang Mai
10 pemandangan berbukit teratas di Chiang Mai: foto dan laluan
Seni dan kraf di Chiang Mai: bengkel dan cenderahati
Kuil dan Kuil Terbaik Chiang Mai: Perjalanan Rohani
Pengembaraan gastronomi di Chiang Mai: khazanah masakan
Chiang Mai untuk pencinta alam semula jadi: trekking dan taman negara
Taman Syurga Chiang Mai dan Taman Botani: flora dan fauna
Air terjun dongeng Chiang Mai: pengembaraan di bawah air terjun
Kedai dan pameran di Chiang Mai: membeli-belah dan cenderahati
Chang Mai dalam satu hari: laluan optimum
Pengangkutan di Chiang Mai: sewa motosikal dan kereta
Sejarah dan budaya Chiang Mai: muzium dan seni bina
Chang Mai dengan basikal: lawatan basikal dan penyewaan
Kewangan di Chiang Mai: pertukaran wang dan ATM
Chiang Mai untuk keluarga: hiburan dan aktiviti
Chiang Mai pada waktu malam: pasar malam dan hiburan
Salun kecantikan di Chiang Mai: penjagaan dan pemakanan untuk kulit, rambut dan jiwa anda
Menyewa kereta di Chiang Mai: kebebasan dan keseronokan daripada mengembara
Salun rambut di Chiang Mai: gaya dan penjagaan rambut anda
Manikur dan pedikur di Chiang Mai: seni penjagaan kuku anda yang sempurna
Kecergasan di Chiang Mai: gaya hidup aktif yang dikelilingi oleh alam semula jadi dan pemandangan yang indah
Insurans perubatan di Chiang Mai: keselamatan dan perlindungan kesihatan anda
Hospital dan klinik perubatan di Chiang Mai: penjagaan perubatan kelas pertama
Penjagaan perubatan kecemasan di Chiang Mai: cara menangani situasi yang tidak dijangka
Urutan Thai di Chiang Mai: seni mistik purba mengembara ke arah harmoni dan penyembuhan
Urutan aroma di Chiang Mai: menyembuhkan minda dan badan melalui aromaterapi dan kelonggaran
Spa terbaik di Chiang Mai: menikmati urutan Thai dan sensasi yang luar biasa
Pakar terapi urut profesional di Chiang Mai: pengalaman dan kemahiran tiada tandingan
Pattaya
10 bar pantai teratas di Pattaya: foto, alamat, harga
Keseronokan masakan di Pattaya: restoran makanan laut terbaik, petua, harga dan alamat
Perisa Thailand: Restoran Thai Tulen di Pattaya
Komunikasi di pantai: pilihan kad SIM dan tarif di Pattaya
Cenderamata Pattaya: hadiah terbaik untuk ingatan
Pattaya dalam 1 hari: laluan dan tarikan utama
Pengangkutan di Pattaya: basikal, tuk-tuk, sewa moped
Perjalanan dalam gaya Pattaya: apa yang perlu dipakai semasa bercuti
Cuti untuk belia di Pattaya: hiburan dan tempat
Cara terbaik untuk ke Pattaya: udara, kereta api, kereta
Aspek Wang di Pattaya: Mata Wang dan Pertukaran Mata Wang
Meneroka Pattaya: Tempat Menarik, Fakta Menarik dan Pameran
10 tempat teratas untuk urutan di Pattaya: kelonggaran dan pemulihan
Sewa kereta di Pattaya yang hebat: tenggelamkan diri anda dalam keselesaan dan kebebasan di jalan raya
Spa Pattaya: penjagaan kulit mewah, penjagaan rambut dan nirvana untuk jiwa
Pendandan rambut moden di Pattaya: gaya rambut bergaya dan penjagaan rambut anda
Manikur dan pedikur yang sempurna di Pattaya: penjagaan kuku yang mewah
Gaya hidup sihat di Pattaya: kecergasan badan dan jiwa di bandar yang indah
Insurans perubatan di Pattaya: perlindungan yang boleh dipercayai untuk kesihatan dan kesejahteraan anda
Hospital dan klinik terbaik di Pattaya: penjagaan perubatan kelas pertama untuk ketenangan fikiran anda
Penjagaan Perubatan Kecemasan di Pattaya: Respons Pantas kepada Situasi Kecemasan
Urutan Thai di Pattaya: seni kuno relaksasi dan penyelenggaraan kesihatan
Urutan aroma yang menenangkan di Pattaya: memulihkan keharmonian jiwa dan badan dengan bantuan aromaterapi
Pattaya Spa: Spa Mewah untuk Relaksasi dan Keseronokan Sepenuhnya
Pakar terapi urut berkelayakan tinggi di Pattaya: pendekatan dan pengalaman profesional
Phuket
10 kelab pantai teratas di Phuket: foto, alamat, harga
Tempat untuk merasai makanan laut terbaik di Phuket: petua, harga dan alamat
Restoran Thai terbaik di Phuket
Internet mudah alih di pulau Phuket: kad SIM dan tarif
Cenderahati teratas yang boleh dibeli di pulau Phuket
Phuket dalam 1 hari: apa yang boleh dilihat dan ke mana hendak pergi (laluan)
Teksi di Phuket: cara memesan teksi dan harga
Phuket untuk golongan muda: hiburan dan tempat untuk dilawati
Perjalanan ke Phuket: cara berpakaian
Pengangkutan di Phuket: teksi, bas dan sewaan skuter
Cara terbaik untuk ke Phuket: kapal terbang, bas, kereta
Kewangan di pulau Phuket: mata wang dan pertukaran wang
Meneroka Pulau Phuket: Tempat Menarik, Fakta dan Pameran
Hotel di Phuket: pilihan mewah dan ekonomik, harga dan ulasan
Menyewa skuter di Phuket: kebebasan bergerak di sekitar bandar
Sewa kereta di Phuket: keselesaan dan kebebasan di jalan raya
Salun kecantikan di pulau Phuket: penjagaan kulit, penjagaan rambut dan kelonggaran
Pendandan rambut di pulau Phuket: gaya rambut bergaya dan penjagaan rambut
Manicure dan pedikur di pulau Phuket: penjagaan kuku yang sempurna
Kecergasan di Phuket: kesihatan dan gaya hidup aktif di bandar besar
Insurans perubatan di Phuket: memastikan keselamatan anda
Hospital dan klinik perubatan di Phuket: penjagaan perubatan berkualiti tinggi
Penjagaan perubatan kecemasan di Phuket: apa yang perlu dilakukan sekiranya berlaku kecemasan
Urutan Thai di Phuket: seni relaksasi dan penyembuhan purba
Urutan aroma di pulau Phuket: pemulihan jiwa dan badan dengan bantuan aromaterapi
Spa Terbaik di Phuket: Nikmati Urutan Thai dan Aromaterapi
Pakar terapi urut profesional di Phuket: pengalaman dan kelayakan
Bangkok
10 kelab malam teratas di Bangkok: gambar, alamat, harga
Syurga gastronomi Bangkok: tempat terbaik untuk makanan laut, petua, harga dan alamat
Restoran dengan masakan Thai asli di Bangkok
Internet Mudah Alih di Bangkok: pilihan kad SIM dan tarif
Cenderahati terbaik yang boleh anda beli di Bangkok
Bangkok dalam 1 hari: laluan dan tarikan utama
Teksi di Bangkok: cara memesan dan harga perkhidmatan
Hiburan dan tempat untuk golongan muda di Bangkok
Perjalanan bergaya ke Bangkok: pakaian untuk dipilih
Pengangkutan di Bangkok: metro, tuk-tuk, sewa moped
Cara terbaik untuk ke Bangkok: udara, kereta api, kereta
Aspek kewangan di Bangkok: mata wang dan pertukaran mata wang
Meneroka Bangkok: Tempat Menarik, Fakta Menarik dan Pameran
10 tempat teratas untuk urutan di Bangkok: kelonggaran dan pemulihan
Kecantikan dan kelonggaran di ibu negara Thailand: menjaga kulit, rambut dan jiwa
Kebebasan dan keselesaan di jalan raya Bangkok: menyewa kereta untuk pengembaraan yang tidak dapat dilupakan
Gaya rambut yang bergaya dan rambut mengikut susunan: salun rambut terbaik di Bangkok
Manikur dan pedikur yang sempurna di tengah-tengah Thailand: penjagaan kuku yang terbaik
Semangat dan aktiviti di Bangkok: kecergasan untuk gaya hidup sihat dan dinamik
Insurans perubatan di Bangkok: melindungi kesejahteraan dan keselamatan anda
Penjagaan perubatan yang sangat baik: hospital dan klinik peringkat tinggi di Bangkok
Harapan dalam Kecemasan: Penjagaan Perubatan di Bangkok untuk Kes Kecemasan
Urutan Thai di tengah-tengah ibu kota: seni relaksasi dan penyembuhan purba di Bangkok
Memulihkan badan dan jiwa melalui urutan aroma: kelonggaran dengan aromaterapi di Bangkok
Memanjakan diri dengan urutan Thai dan aromaterapi: spa terbaik di Bangkok
Pakar terapi urut yang berpengalaman dan berkelayakan: profesionalisme dan penjagaan di Bangkok
