Hua Hin
Topp 10 strandklubbar i Hua Hin: foton, adresser, priser
Var du kan prova utsökt skaldjur i Hua Hin: tips, priser och adresser
De bästa thairestaurangerna i Hua Hin
SIM-kort för mobilt Internet i Hua Hin
Toppsouvenirer du kan köpa i Hua Hin
Hua Hin på 1 dag: vad man ska se och vart man ska åka (rutt)
Taxi i Hua Hin: hur man beställer en taxi och priser
Hua Hin för ungdomar: saker att göra och platser att besöka
Resa till Hua Hin: hur man klär sig
Transport i Hua Hin: tuk-tuk, bussar och skoteruthyrning
Bästa sätten att ta sig till Hua Hin: buss, tåg, bil
Finans i Hua Hin: valuta- och penningväxling
Utforska Hua Hin: Intressanta platser, fakta och mässor
Topp 10 platser för massage i Hua Hin: avkoppling och återhämtning
Hua Hin hotell: lyx- och budgetalternativ, priser och recensioner
Att hyra en skoter i Hua Hin: rörelsefrihet i staden
Biluthyrning i Hua Hin: bekvämlighet och frihet på vägarna
Skönhetssalonger i Hua Hin: hudvård, hårvård och avkoppling
Frisörsalonger i Hua Hin: snygga frisyrer och hårvård
Manikyr och pedikyr i Hua Hin: perfekt nagelvård
Fitness i Hua Hin: hälsa och aktiv livsstil i en storstad
Sjukförsäkring i Hua Hin: hur du säkerställer din säkerhet
Sjukhus och medicinska kliniker i Hua Hin: sjukvård av hög kvalitet
Akutsjukvård i Hua Hin: vad man ska göra i nödfall
Thaimassage i Hua Hin: den uråldriga konsten att avslappna och läka
Aromamassage i Hua Hin: återställande av kropp och själ med aromaterapi
Bästa spa i Hua Hin: Njut av thailändsk massage och aromaterapi
Professionella massageterapeuter i Hua Hin: erfarenhet och kvalifikationer
Chang Mai
Topp 10 kuperade vyer i Chiang Mai: foton och rutter
Konst och hantverk i Chiang Mai: workshops och souvenirer
De bästa templen och helgedomarna i Chiang Mai: En andlig resa
Gastronomiska äventyr i Chiang Mai: kulinariska skatter
Chiang Mai för naturälskare: vandring och nationalparker
Chiang Mais paradisträdgårdar och botaniska trädgårdar: flora och fauna
Sagovattenfall i Chiang Mai: äventyr under vattenfallet
Butiker och mässor i Chiang Mai: shopping och souvenirer
Chang Mai på en dag: den optimala rutten
Transport i Chiang Mai: motorcykel- och biluthyrning
Chiang Mais historia och kultur: museer och arkitektur
Chang Mai med cykel: cykelturer och uthyrning
Finans i Chiang Mai: växling av pengar och bankomater
Chiang Mai för familjer: underhållning och aktiviteter
Chiang Mai på kvällen: nattmarknader och underhållning
Skönhetssalonger i Chiang Mai: vård och näring för din hud, hår och själ
Att hyra en bil i Chiang Mai: frihet och nöje att resa

Manikyr och pedikyr i Chiang Mai: den perfekta konsten att ta hand om dina naglar
Fitness i Chiang Mai: en aktiv livsstil omgiven av natur och magnifik natur
Sjukförsäkring i Chiang Mai: säkerhet och skydd för din hälsa
Sjukhus och medicinska kliniker i Chiang Mai: förstklassig sjukvård
Akutsjukvård i Chiang Mai: hur man hanterar oväntade situationer
Thaimassage i Chiang Mai: den antika mystiska konsten att resa till harmoni och helande
Aromamassage i Chiang Mai: helande av sinne och kropp genom aromaterapi och avslappning
De bästa spaanläggningarna i Chiang Mai: njuter av thailändsk massage och otroliga upplevelser
Professionella massageterapeuter i Chiang Mai: erfarenhet och oöverträffad skicklighet
Pattaya
Topp 10 strandbarer i Pattaya: foton, adresser, priser
Kulinariskt nöje i Pattaya: bästa skaldjursrestauranger, tips, priser och adresser
Smaker av Thailand: Autentiska thailändska restauranger i Pattaya
Kommunikation vid kusten: val av SIM-kort och tariffer i Pattaya
Pattaya souvenirer: de bästa presenterna för minnet
Pattaya på 1 dag: rutt och huvudattraktioner
Transport i Pattaya: cyklar, tuk-tuks, mopeduthyrning
Att resa i Pattaya-stil: vad man ska ha på sig på semestern
Semester för ungdomar i Pattaya: underhållning och platser
De bästa sätten att ta sig till Pattaya: flyg, tåg, bil
Pengaaspekter i Pattaya: Valuta och valutaväxling
Utforska Pattaya: Fascinerande platser, intressanta fakta och mässor
Topp 10 platser för massage i Pattaya: avkoppling och återhämtning
Hyr en bil i fantastiska Pattaya: fördjupa dig i komfort och frihet på vägarna
Pattaya spa: lyxig hudvård, hårvård och nirvana för själen
Moderna frisörer i Pattaya: snygga frisyrer och ta hand om ditt hår
Perfekt manikyr och pedikyr i Pattaya: lyxig nagelvård
Hälsosam livsstil i Pattaya: fitness för kropp och själ i en pittoresk stad
Sjukförsäkring i Pattaya: tillförlitligt skydd för din hälsa och ditt välbefinnande
De bästa sjukhusen och klinikerna i Pattaya: förstklassig medicinsk vård för din sinnesfrid
Akutsjukvård i Pattaya: Snabbt svar på nödsituationer
Thaimassage i Pattaya: den uråldriga konsten av avslappning och hälsovård
Avkopplande arommassage i Pattaya: återställande av harmoni mellan själ och kropp med hjälp av aromaterapi
Pattaya Spa: Lyxiga spa för total avkoppling och nöje
Högt kvalificerade massageterapeuter i Pattaya: professionellt tillvägagångssätt och erfarenhet
Phuket
Topp 10 strandklubbar i Phuket: foton, adresser, priser
Var du kan smaka den bästa skaldjuren på Phuket: tips, priser och adresser
De bästa thairestaurangerna i Phuket
Mobilt internet på ön Phuket: SIM-kort och tariffer
Toppsouvenirer som kan köpas på ön Phuket
Phuket på 1 dag: vad man ska se och vart man ska åka (rutt)
Taxi på Phuket: hur man beställer en taxi och priser
Phuket för ungdomar: underhållning och platser att besöka
Att resa till Phuket: hur man klär sig
Transport på Phuket: taxi, bussar och skoteruthyrning
De bästa sätten att ta sig till Phuket: flyg, buss, bil
Finansiering på ön Phuket: valuta- och penningväxling
Utforska Phuket Island: Intressanta platser, fakta och mässor
Hotell i Phuket: lyxiga och ekonomiska alternativ, priser och recensioner
Att hyra en skoter i Phuket: rörelsefrihet runt staden
Biluthyrning på Phuket: komfort och frihet på vägarna
Skönhetssalonger på ön Phuket: hudvård, hårvård och avkoppling
Frisörer på ön Phuket: snygga frisyrer och hårvård
Manikyr och pedikyr på ön Phuket: perfekt nagelvård
Fitness i Phuket: hälsa och aktiv livsstil i en storstad
Sjukförsäkring i Phuket: garanterar din säkerhet
Sjukhus och medicinska kliniker i Phuket: sjukvård av hög kvalitet
Akutsjukvård i Phuket: vad man ska göra i nödfall
Thaimassage på Phuket: den uråldriga konsten av avkoppling och helande
Aromamassage på ön Phuket: återställande av själ och kropp med hjälp av aromaterapi
Bästa spa i Phuket: Njut av thailändsk massage och aromaterapi
Professionella massageterapeuter i Phuket: erfarenhet och kvalifikationer
Bangkok
Topp 10 nattklubbar i Bangkok: foton, adresser, priser
Gastronomiska paradiset i Bangkok: bästa ställena för skaldjur, tips, priser och adresser
Restauranger med äkta thailändsk mat i Bangkok
Mobilt internet i Bangkok: val av SIM-kort och tariffer
De bästa souvenirerna du kan köpa i Bangkok
Bangkok på 1 dag: rutt och huvudattraktioner
Taxi i Bangkok: hur man beställer och priser för tjänster
Underhållning och platser för ungdomar i Bangkok
Snygg resa till Bangkok: vilken outfit att välja
Transport i Bangkok: tunnelbana, tuk-tuk, mopeduthyrning
De bästa sätten att ta sig till Bangkok: flyg, tåg, bil
Finansiella aspekter i Bangkok: valuta och valutaväxling
Utforska Bangkok: Fascinerande platser, intressanta fakta och mässor
Topp 10 platser för massage i Bangkok: avkoppling och återhämtning
Skönhet och avkoppling i Thailands huvudstad: vård för hud, hår och själ
Frihet och komfort på Bangkoks vägar: hyr en bil för ett oförglömligt äventyr
Snygga frisyrer och hår i ordning: de bästa frisörsalongerna i Bangkok
Perfekt manikyr och pedikyr i hjärtat av Thailand: förstklassig nagelvård
Vigor och aktivitet i Bangkok: fitness för en hälsosam och dynamisk livsstil
Sjukförsäkring i Bangkok: skydda ditt välbefinnande och säkerhet
Utmärkt medicinsk vård: högkvalitativa sjukhus och kliniker i Bangkok
Hope in Emergency: Medical Care in Bangkok for Emergency Cases
Thaimassage i hjärtat av huvudstaden: den uråldriga konsten av avkoppling och helande i Bangkok
Återställande av kropp och själ genom aromamassage: avkoppling med aromaterapi i Bangkok
Njut av thaimassage och aromaterapi: de bästa spaanläggningarna i Bangkok
Erfarna och kvalificerade massageterapeuter: professionalism och omsorg i Bangkok
