Hua Hin
10 najboljih klubova na plaži u Hua Hinu: fotografije, adrese, cijene
Gdje probati ukusne morske plodove u Hua Hinu: savjeti, cijene i adrese
Najbolji tajlandski restorani u Hua Hinu
SIM kartice za mobilni internet u Hua Hinu
Najbolji suveniri koje možete kupiti u Hua Hinu
Hua Hin za 1 dan: šta vidjeti i kuda ići (ruta)
Taksi u Hua Hinu: kako naručiti taksi i cijene
Hua Hin za mlade: stvari koje treba raditi i mjesta koja treba posjetiti
Putovanje u Hua Hin: kako se oblačiti
Prijevoz u Hua Hinu: tuk-tukovi, iznajmljivanje autobusa i skutera
Najbolji načini da dođete do Hua Hina: autobus, voz, automobil
Financije u Hua Hinu: valuta i razmjena novca
Istraživanje Hua Hina: Zanimljiva mjesta, činjenice i sajmovi
Top 10 mjesta za masažu u Hua Hinu: opuštanje i oporavak
Hua Hin hoteli: luksuzne i jeftine opcije, cijene i recenzije
Iznajmljivanje skutera u Hua Hinu: sloboda kretanja po gradu
Iznajmljivanje automobila u Hua Hinu: udobnost i sloboda na putevima
Kozmetički saloni u Hua Hinu: njega kože, njega kose i opuštanje
Frizerski saloni u Hua Hinu: elegantne frizure i njega kose
Manikir i pedikir u Hua Hinu: savršena njega noktiju
Fitnes u Hua Hinu: zdravlje i aktivan stil života u velikom gradu
Medicinsko osiguranje u Hua Hinu: kako osigurati svoju sigurnost
Bolnice i medicinske klinike u Hua Hinu: visokokvalitetna medicinska njega
Hitna medicinska pomoć u Hua Hinu: šta učiniti u hitnom slučaju
Tajlandska masaža u Hua Hinu: drevna umjetnost opuštanja i liječenja
Aroma masaža u Hua Hinu: vraćanje tijela i duše aromaterapijom
Najbolji spa centri u Hua Hinu: uživajte u tajlandskoj masaži i aromaterapiji
Profesionalni masažni terapeuti u Hua Hinu: iskustvo i kvalifikacije
Chang Mai
Top 10 brdovitih pogleda u Chiang Maiju: fotografije i rute
Umjetnost i obrt u Chiang Maiju: radionice i suveniri
Najbolji hramovi i svetilišta Chiang Maija: duhovno putovanje
Gastronomske avanture u Chiang Maiju: kulinarsko blago
Chiang Mai za ljubitelje prirode: trekking i nacionalni parkovi
Rajski vrtovi i botanički vrtovi Chiang Mai: flora i fauna
Bajkoviti vodopadi Chiang Maija: avanture ispod vodopada
Prodavnice i sajmovi u Chiang Maiju: kupovina i suveniri
Chang Mai u jednom danu: optimalna ruta
Prijevoz u Chiang Maiu: iznajmljivanje motocikala i automobila
Istorija i kultura Chiang Maija: muzeji i arhitektura
Chang Mai biciklom: biciklističke ture i iznajmljivanje
Financije u Chiang Maiju: mjenjačnica i bankomati
Chiang Mai za porodice: zabava i aktivnosti
Chiang Mai u večernjim satima: noćne pijace i zabava
Kozmetički saloni u Chiang Maiju: maženje i ishrana za vašu kožu, kosu i dušu
Iznajmljivanje automobila u Chiang Maiju: sloboda i zadovoljstvo putovanja
Frizerski saloni u Chiang Maiju: stilizirajte i njegujte svoju kosu
Manikir i pedikir u Chiang Maiju: savršena umjetnost njege vaših noktiju
Fitnes u Chiang Maiju: aktivan stil života okružen prirodom i veličanstvenim krajolikom
Medicinsko osiguranje u Chiang Maiju: sigurnost i zaštita vašeg zdravlja
Bolnice i medicinske klinike u Chiang Maiju: prvoklasna medicinska njega
Hitna medicinska pomoć u Chiang Maiju: kako se nositi s neočekivanim situacijama
Tajlandska masaža u Chiang Maiju: drevna mistična umjetnost putovanja u harmoniju i iscjeljenje
Aroma masaža u Chiang Maiju: iscjeljivanje uma i tijela kroz aromaterapiju i opuštanje
Najbolje banje u Chiang Maiju: uživanje u tajlandskoj masaži i nevjerovatnim senzacijama
Profesionalni terapeuti za masažu u Chiang Maiju: iskustvo i vještina bez premca
Pattaya
Top 10 beach barova u Pattayi: fotografije, adrese, cijene
Kulinarski užitak u Pattayi: najbolji riblji restorani, savjeti, cijene i adrese
Okusi Tajlanda: autentični tajlandski restorani u Pataji
Komunikacije na obali: izbor SIM kartica i tarifa u Pattayi
Pattaya suveniri: najbolji pokloni za uspomenu
Pattaya za 1 dan: ruta i glavne atrakcije
Prijevoz u Pattayi: bicikli, tuk-tukovi, iznajmljivanje mopeda
Putovanje u Pattaya stilu: šta obući na odmoru
Odmor za mlade u Pattayi: zabava i mjesta
Najbolji načini da dođete do Pattaye: avionom, vozom, automobilom
Aspekti novca u Pattayi: valuta i razmjena valuta
Istraživanje Pattaye: fascinantna mjesta, zanimljive činjenice i sajmovi
Top 10 mesta za masažu u Pataji: opuštanje i oporavak
Iznajmite automobil u fantastičnoj Pattayi: uronite u udobnost i slobodu na putevima
Pattaya banje: luksuzna njega kože, njega kose i nirvana za dušu
Moderni frizeri u Pattayi: elegantne frizure i njega vaše kose
Savršen manikir i pedikir u Pattayi: luksuzna njega noktiju
Zdrav način života u Pattayi: fitnes za dušu i tijelo u slikovitom gradu
Medicinsko osiguranje u Pattayi: pouzdana zaštita za vaše zdravlje i dobrobit
Najbolje bolnice i klinike u Pattayi: prvoklasna medicinska njega za vaš mir
Hitna medicinska pomoć u Pattayi: brz odgovor na hitne situacije
Tajlandska masaža u Pattayi: drevna umjetnost opuštanja i održavanja zdravlja
Opuštajuća aroma masaža u Pattayi: vraćanje harmonije duše i tijela uz pomoć aromaterapije
Pattaya Spa: Luksuzni spa centri za potpuno opuštanje i užitak
Visokokvalificirani masažni terapeuti u Pattayi: profesionalni pristup i iskustvo
Phuket
10 najboljih klubova na plaži u Puketu: fotografije, adrese, cijene
Gdje kušati najbolju morsku hranu na Phuketu: savjeti, cijene i adrese
Najbolji tajlandski restorani na Phuketu
Mobilni internet na ostrvu Phuket: SIM kartice i tarife
Vrhunski suveniri koji se mogu kupiti na ostrvu Puket
Phuket za 1 dan: šta vidjeti i kuda ići (ruta)
Taksi na Phuketu: kako naručiti taksi i cijene
Phuket za mlade: zabava i mjesta za posjetiti
Putovanje na Phuket: kako se oblačiti
Prevoz na Phuketu: taksiji, iznajmljivanje autobusa i skutera
Najbolji načini da dođete do Phuketa: avionom, autobusom, automobilom
Finansije na ostrvu Phuket: valuta i razmjena novca
Istraživanje ostrva Phuket: zanimljiva mjesta, činjenice i sajmovi
Hoteli u Phuketu: luksuzne i ekonomične opcije, cijene i recenzije
Iznajmljivanje skutera na Phuketu: sloboda kretanja po gradu
Iznajmljivanje automobila na Phuketu: udobnost i sloboda na putevima
Kozmetički saloni na ostrvu Phuket: njega kože, njegu kose i opuštanje
Frizeri na ostrvu Phuket: stilske frizure i njega kose
Manikir i pedikir na ostrvu Phuket: savršena njega noktiju
Fitnes na Phuketu: zdravlje i aktivan način života u velikom gradu
Medicinsko osiguranje na Phuketu: osiguravamo vašu sigurnost
Bolnice i medicinske klinike u Phuketu: visokokvalitetna medicinska njega
Hitna medicinska pomoć u Phuketu: šta učiniti u hitnom slučaju
Tajlandska masaža na Phuketu: drevna umjetnost opuštanja i liječenja
Aroma masaža na ostrvu Phuket: obnavljanje duše i tijela uz pomoć aromaterapije
Najbolji spa centri na Phuketu: uživajte u tajlandskoj masaži i aromaterapiji
Profesionalni masažni terapeuti na Phuketu: iskustvo i kvalifikacije
Bangkok
Top 10 noćnih klubova u Bangkoku: fotografije, adrese, cijene
Gastronomski raj Bangkoka: najbolja mjesta za plodove mora, savjeti, cijene i adrese
Restorani sa autentičnom tajlandskom kuhinjom u Bangkoku
Mobilni internet u Bangkoku: izbor SIM kartica i tarifa
Najbolji suveniri koje možete kupiti u Bangkoku
Bangkok za 1 dan: ruta i glavne atrakcije
Taksi u Bangkoku: kako naručiti i cijene usluga
Zabava i mjesta za mlade u Bangkoku
Stilsko putovanje u Bangkok: koju odjeću odabrati
Prevoz u Bangkoku: metro, tuk-tuks, iznajmljivanje mopeda
Najbolji načini da dođete do Bangkoka: avionom, vozom, automobilom
Finansijski aspekti u Bangkoku: valuta i razmjena valuta
Istraživanje Bangkoka: fascinantna mjesta, zanimljive činjenice i sajmovi
Top 10 mjesta za masažu u Bangkoku: opuštanje i oporavak
Ljepota i opuštanje u glavnom gradu Tajlanda: njega kože, kose i duše
Sloboda i udobnost na putevima Bangkoka: iznajmite automobil za nezaboravnu avanturu
Elegantne frizure i kosa po redu: najbolji frizerski saloni u Bangkoku
Savršen manikir i pedikir u srcu Tajlanda: vrhunska njega noktiju
Energija i aktivnost u Bangkoku: fitnes za zdrav i dinamičan način života
Medicinsko osiguranje u Bangkoku: zaštita vašeg blagostanja i sigurnosti
Odlična medicinska njega: visokokvalitetne bolnice i klinike u Bangkoku
Nada u hitnim slučajevima: medicinska njega u Bangkoku za hitne slučajeve
Tajlandska masaža u srcu glavnog grada: drevna umjetnost opuštanja i liječenja u Bangkoku
Vraćanje tijela i duše kroz aromamasažu: opuštanje uz aromaterapiju u Bangkoku
Prepuštanje tajlandskoj masaži i aromaterapiji: najbolje banje u Bangkoku
Iskusni i kvalifikovani terapeuti masaže: profesionalizam i briga u Bangkoku
