Hua Hin
Top 10 des clubs de plage à Hua Hin : photos, adresses, tarifs
Où déguster de délicieux fruits de mer à Hua Hin : conseils, tarifs et adresses
Meilleurs restaurants thaïlandais à Hua Hin
Cartes SIM pour Internet mobile à Hua Hin
Les meilleurs souvenirs que vous pouvez acheter à Hua Hin
Hua Hin en 1 jour : que voir et où aller (itinéraire)
Taxi à Hua Hin : comment commander un taxi et tarifs
Hua Hin pour les jeunes : choses à faire et lieux à visiter
Voyage à Hua Hin : comment s&#39;habiller
Transports à Hua Hin : location de tuk-tuks, bus et scooters
Meilleurs moyens de se rendre à Hua Hin : bus, train, voiture
Finances à Hua Hin : devises et change
Explorer Hua Hin : lieux intéressants, faits et foires
Top 10 des lieux de massage à Hua Hin : détente et récupération
Hôtels à Hua Hin : options de luxe et économiques, prix et avis
Louer un scooter à Hua Hin : liberté de mouvement dans la ville
Location de voiture à Hua Hin : commodité et liberté sur les routes
Instituts de beauté à Hua Hin : soins de la peau, soins capillaires et relaxation
Salons de coiffure à Hua Hin : coiffures et soins capillaires stylés
Manucure et pédicure à Hua Hin : un soin parfait des ongles
Fitness à Hua Hin : santé et mode de vie actif dans une grande ville
Assurance médicale à Hua Hin : comment assurer votre sécurité
Hôpitaux et cliniques médicales à Hua Hin : des soins médicaux de haute qualité
Soins médicaux d&#39;urgence à Hua Hin : que faire en cas d&#39;urgence
Massage thaïlandais à Hua Hin : l&#39;art ancien de la relaxation et de la guérison
Massage aromatique à Hua Hin : restaurer le corps et l&#39;esprit grâce à l&#39;aromathérapie
Meilleurs spas à Hua Hin : profitez du massage thaïlandais et de l&#39;aromathérapie
Massothérapeutes professionnels à Hua Hin : expérience et qualifications
Chang Mai
Top 10 des vues vallonnées à Chiang Mai : photos et itinéraires
Arts et artisanat à Chiang Mai : ateliers et souvenirs
Les meilleurs temples et sanctuaires de Chiang Mai : un voyage spirituel
Aventures gastronomiques à Chiang Mai : trésors culinaires
Chiang Mai pour les amoureux de la nature : trekking et parcs nationaux
Jardins paradisiaques et jardins botaniques de Chiang Mai : faune et flore
Cascades de contes de fées de Chiang Mai : aventures sous la cascade
Boutiques et foires à Chiang Mai : shopping et souvenirs
Chang Mai en une journée : l&#39;itinéraire optimal
Transports à Chiang Mai : location de motos et de voitures
Histoire et culture de Chiang Mai : musées et architecture
Chang Mai à vélo : balades et locations de vélo
Finance à Chiang Mai : change d’argent et distributeurs automatiques
Chiang Mai en famille : animations et activités
Chiang Mai le soir : marchés nocturnes et animations
Instituts de beauté à Chiang Mai : soins et nutrition pour votre peau, vos cheveux et votre âme
Louer une voiture à Chiang Mai : liberté et plaisir de voyager
Coiffeurs à Chiang Mai : coiffer et prendre soin de vos cheveux
Manucure et pédicure à Chiang Mai : l&#39;art parfait de prendre soin de ses ongles
Fitness à Chiang Mai : un mode de vie actif en pleine nature et de magnifiques paysages
Assurance médicale à Chiang Mai : sécurité et protection de votre santé
Hôpitaux et cliniques médicales à Chiang Mai : des soins médicaux de premier ordre
Soins médicaux d&#39;urgence à Chiang Mai : comment faire face aux situations inattendues
Massage thaïlandais à Chiang Mai : l&#39;art mystique ancien du voyage vers l&#39;harmonie et la guérison
Massage aromatique à Chiang Mai : soigner l&#39;esprit et le corps grâce à l&#39;aromathérapie et à la relaxation
Les meilleurs spas de Chiang Mai : profiter d&#39;un massage thaïlandais et de sensations incroyables
Massothérapeutes professionnels à Chiang Mai : expérience et compétence inégalée
Pattaya
Top 10 des bars de plage de Pattaya : photos, adresses, tarifs
Plaisir culinaire à Pattaya : meilleurs restaurants de fruits de mer, bons plans, tarifs et adresses
Saveurs de Thaïlande : restaurants thaïlandais authentiques à Pattaya
Communications sur la côte : choix de cartes SIM et tarifs à Pattaya
Souvenirs de Pattaya : les meilleurs cadeaux pour la mémoire
Pattaya en 1 jour : itinéraire et principales attractions
Transport à Pattaya : vélos, tuk-tuks, location de cyclomoteurs
